--------------------
--------------------
--------------------
--------------------
--01111112----------
--45555556----------
------------011112--
------------455556--
--------------------
--------01112-------
--------45556-------
--------------012---
--------------456---
-----------311111111
11111111111788888888
